-
10|10
RRRRRRRRRR
RRRRRRRRRR
RRRRRRRRRR
RRRRRRRRRR
√√√√√√√√√√
RRRRRRRRRR
RRRRRRRRRR
RRRRRRRRRR
RRRRRRRRRR
RRRRRRRRRR
-
10|10
øRRRRRRRRø
√√√√√√√√√√
RRRRRRRRRR
RRRRRRRRRR
RRRRRRRRRR
RRRRRRRRRR
RRRRRRRRRR
RRRRRRRRRR
√√√√√√√√√√
øRRRRRRRRø
-
10|10
ø++++++++ø
√√√√√√√+√√
RRRRRRR+RR
RRRRRRR+RR
RRRRRRR+RR
RRRRRRR+RR
RRRRRRR+RR
RRRRRRR+RR
√√√√√√√+√√
ø++++++++ø
-
10|10
RRRR∫RRRRR
RRRR∫RRRRR
RRRR∫RRRRR
RRRR∫RRRRR
∫∫∫∫∫∫∫∫∫∫
RRRR∫RRRRR
RRRR∫RRRRR
RRRR∫RRRRR
RRRR∫RRRRR
RRRR∫RRRRR